aabond -> ond
abalone -> lone
abased -> sed
abaser -> ser
abasers -> sers
abases -> ses
abashed -> shed
abashes -> shes
abasing -> sing
abat -> t
abated -> ted
abater -> ter
abates -> tes
abating -> ting
abatis -> tis
abator -> tor
abbasid -> sid
abbatial -> til
abbess -> ess
abbesses -> esses
abbots -> ots
abbott -> ott
abbrev -> rev
abcbook -> cook
abcbooks -> cooks
abcde -> cde
abcdef -> cdef
abcrunch -> crunch
abcrunches -> crunches
abdel -> del
abdication -> diction
abdications -> dictions
abduct -> duct
abducted -> ducted
abducting -> ducting
abducts -> ducts
abeam -> em
abeer -> eer
abele -> ele
abelia -> eli
abelian -> elin
abell -> ell
abels -> els
abend -> end
abent -> ent
abets -> ets
abetting -> etting
abhor -> hor
abhors -> hors
abide -> ide
abided -> ided
abides -> ides
abiding -> iding
abies -> ies
abilene -> ilene
abill -> ill
abind -> ind
abinge -> inge
abinitio -> initio
abintra -> intr
abite -> ite
abitof -> itof
abjure -> jure
ablast -> lst
ablate -> lte
ablaut -> lut
abler -> ler
ablest -> lest
abloom -> loom
ablush -> lush
abner -> ner
aboard -> ord
abode -> ode
abodes -> odes
aboil -> oil
abombs -> oms
abone -> one
aboon -> oon
aboral -> orl
aborc -> orc
abore -> ore
abort -> ort
aborts -> orts
about -> out
aboutto -> outto
abovo -> ovo
abowl -> owl
abpositive -> positive
abrams -> rms
abraxas -> rxs
abreact -> rect
abreacts -> rects
abreast -> rest
abridge -> ridge
abridged -> ridged
abridges -> ridges
abridging -> ridging
abrim -> rim
abroad -> rod
abroller -> roller
abrollers -> rollers
abscam -> scm
abscission -> scission
absent -> sent
absentia -> senti
absit -> sit
absolute -> solute
absolutes -> solutes
absolution -> solution
absolutions -> solutions
absolve -> solve
absolved -> solved
absolver -> solver
absolvers -> solvers
absolves -> solves
absolving -> solving
absorb -> sor
absorber -> sorer
absorption -> sorption
absurd -> surd
abswitch -> switch
abswitches -> switches
abt -> t
abtest -> test
abtesting -> testing
abtests -> tests
abtoner -> toner
abtoners -> toners
abubble -> ule
abump -> ump
abunch -> unch
abuse -> use
abused -> used
abuser -> user
abusers -> users
abuses -> uses
abusing -> using
abut -> ut
abutter -> utter
abutters -> utters
abwheel -> wheel
abwheels -> wheels
abworkout -> workout
abworkouts -> workouts
acerb -> cer
acerbates -> certes
acerbic -> ceric
achebe -> chee
aclub -> clu
adbiz -> diz
adebt -> det
adlib -> dli
adobe -> doe
adobes -> does
adobo -> doo
adobos -> doos
adorbs -> dors
aerobatic -> erotic
aerobatics -> erotics
airbed -> ired
airbubble -> irule
ajobon -> joon
alabaman -> lmn
albans -> lns
albee -> lee
albees -> lees
alben -> len
albin -> lin
albino -> lino
albinos -> linos
albion -> lion
albom -> lom
album -> lum
albumen -> lumen
albuminous -> luminous
albums -> lums
albundy -> lundy
alibaba -> li
alibi -> lii
alimb -> lim
amber -> mer
amberale -> merle
ambers -> mers
ambiance -> mince
ambien -> mien
ambit -> mit
ambo -> mo
ambush -> mush
ambushed -> mushed
ambusher -> musher
ambushes -> mushes
ambushing -> mushing
ameba -> me
amebae -> mee
amebas -> mes
amiable -> mile
amoeba -> moe
amoebas -> moes
anabel -> nel
annabe -> nne
aorb -> or
arabella -> rell
arabian -> rin
arabiansea -> rinse
arabic -> ric
arabica -> ric
arabis -> ris
arbela -> rel
arbella -> rell
arbus -> rus
arbys -> rys
aruban -> run
asabell -> sell
asbig -> sig
ascribed -> scried
ascribes -> scries
ashbin -> shin
ashbins -> shins
ashby -> shy
astilbe -> stile
atab -> t
ataboil -> toil
atabout -> tout
atbats -> tts
atbest -> test
athrob -> thro
aubade -> ude
aubrey -> urey
available -> ville
avenueb -> venue
averb -> ver
baaing -> ing
baalist -> list
babadook -> dook
babaloo -> loo
babaoriley -> oriley
babbitt -> itt
babbled -> led
babbledon -> ledon
babbleon -> leon
babbler -> ler
babbles -> les
babbling -> ling
babblings -> lings
babcock -> cock
babelfish -> elfish
babels -> els
babette -> ette
babied -> ied
babies -> ies
baboon -> oon
baboons -> oons
babybear -> yer
babybears -> yers
babybell -> yell
babybells -> yells
babybooks -> yooks
babying -> ying
bachit -> chit
backbone -> ckone
backs -> cks
bacon -> con
bacons -> cons
bacos -> cos
badabing -> ding
badarea -> dre
badart -> drt
badbet -> det
badbets -> dets
baddata -> ddt
badear -> der
badegree -> degree
badegrees -> degrees
badems -> dems
baden -> den
bader -> der
badinage -> dinge
baditch -> ditch
badoff -> doff
badun -> dun
baers -> ers
bagel -> gel
bagels -> gels
bagit -> git
bagless -> gless
bagmen -> gmen
bahais -> his
bahamas -> hms
bahian -> hin
bahts -> hts
bailable -> ille
bailed -> iled
bailer -> iler
bailie -> ilie
bails -> ils
baines -> ines
baiter -> iter
baiters -> iters
baits -> its
baize -> ize
bajer -> jer
bajillion -> jillion
baker -> ker
baking -> king
bakings -> kings
balatas -> lts
balboas -> los
balds -> lds
baled -> led
baler -> ler
bales -> les
bali -> li
balin -> lin
baline -> line
baling -> ling
ballad -> lld
ballads -> llds
baloo -> loo
baluster -> luster
balusters -> lusters
bambina -> min
bambinas -> mins
bambini -> mini
bambinos -> minos
bambis -> mis
bamboo -> moo
bamboos -> moos
bammbamm -> mmmm
banco -> nco
band -> nd
banda -> nd
bandb -> nd
bane -> ne
banes -> nes
bangor -> ngor
bangs -> ngs
banian -> nin
bano -> no
banos -> nos
baraboo -> roo
barband -> rnd
barbands -> rnds
barbecue -> recue
barbed -> red
barbel -> rel
barbell -> rell
barbels -> rels
barbet -> ret
barbets -> rets
barbill -> rill
barbills -> rills
barbing -> ring
barbless -> rless
bards -> rds
bareall -> rell
bareback -> reck
bared -> red
barely -> rely
barents -> rents
bares -> res
barest -> rest
baric -> ric
barilla -> rill
baring -> ring
barite -> rite
barites -> rites
barman -> rmn
barms -> rms
barnabas -> rns
barns -> rns
barolo -> rolo
barolos -> rolos
baron -> ron
barons -> rons
baroque -> roque
barrs -> rrs
bartabs -> rts
barts -> rts
baseball -> sell
baseballs -> sells
based -> sed
basel -> sel
baser -> ser
bases -> ses
bashed -> shed
basher -> sher
bashes -> shes
bashin -> shin
basho -> sho
basial -> sil
basic -> sic
basics -> sics
basie -> sie
basil -> sil
basin -> sin
basinful -> sinful
basing -> sing
basinger -> singer
basins -> sins
basis -> sis
basked -> sked
baskin -> skin
basotho -> sotho
bassi -> ssi
bastaya -> sty
baste -> ste
baster -> ster
basters -> sters
bastes -> stes
bastille -> stille
basting -> sting
bastings -> stings
basts -> sts
bat -> t
bataan -> tn
batboy -> toy
batboys -> toys
bated -> ted
bates -> tes
bathbomb -> thom
bathe -> the
bathes -> thes
bathing -> thing
batho -> tho
bathos -> thos
bathrobe -> throe
bathrobes -> throes
baths -> ths
batin -> tin
bating -> ting
batmen -> tmen
baton -> ton
batons -> tons
bator -> tor
batrope -> trope
batropes -> tropes
batsub -> tsu
batty -> tty
bauble -> ule
baubles -> ules
baugh -> ugh
baums -> ums
baverage -> verge
bavier -> vier
bawds -> wds
bayer -> yer
bayes -> yes
baying -> ying
bayonne -> yonne
bayou -> you
bayous -> yous
bazillion -> zillion
bazookas -> zooks
bazoom -> zoom
bazooms -> zooms
bdays -> dys
beach -> ech
beacon -> econ
beadear -> eder
beader -> eder
beads -> eds
beady -> edy
beaked -> eked
beale -> ele
bealion -> elion
beall -> ell
bealls -> ells
beals -> els
beam -> em
beame -> eme
beamends -> emends
beamer -> emer
beams -> ems
beanbag -> eng
beanbags -> engs
beancounter -> encounter
beancounters -> encounters
beane -> ene
beaner -> ener
beano -> eno
beans -> ens
beantree -> entree
bearable -> erle
bearin -> erin
bears -> ers
bearse -> erse
beasport -> esport
beast -> est
beasts -> ests
beaton -> eton
beats -> ets
beatto -> etto
beaus -> eus
beaux -> eux
beaver -> ever
beavers -> evers
bedaub -> edu
belas -> els
belay -> ely
belays -> elys
belgian -> elgin
bella -> ell
bellas -> ells
bema -> em
benatar -> entr
benday -> endy
berate -> erte
berates -> ertes
berea -> ere
beria -> eri
berra -> err
berras -> errs
besame -> esme
betas -> ets
betcha -> etch
bianca -> inc
biases -> ises
biasing -> ising
bigbaby -> igy
bilbao -> ilo
biloba -> ilo
binaca -> inc
bistable -> istle
bitat -> itt
blabbed -> led
blabber -> ler
blabbing -> ling
blaine -> line
blaise -> lise
blast -> lst
blasts -> lsts
blats -> lts
bleach -> lech
bleacher -> lecher
bleachers -> lechers
bleaches -> leches
bleak -> lek
blear -> ler
bleat -> let
bleats -> lets
blewa -> lew
bloat -> lot
bloats -> lots
boar -> or
board -> ord
boarder -> order
boarders -> orders
boards -> ords
boars -> ors
boast -> ost
boaster -> oster
boasters -> osters
boats -> ots
bobatea -> ote
bobbarr -> orr
bobcat -> oct
bobcats -> octs
bolas -> ols
bombay -> omy
bombbay -> omy
bonita -> onit
boobama -> oom
bora -> or
borat -> ort
boreal -> orel
boreas -> ores
bossa -> oss
bract -> rct
bracts -> rcts
brads -> rds
braes -> res
brags -> rgs
brahe -> rhe
braid -> rid
braider -> rider
braiders -> riders
braiding -> riding
braidings -> ridings
braids -> rids
brailed -> riled
brailing -> riling
braille -> rille
brain -> rin
braino -> rino
braise -> rise
braises -> rises
braising -> rising
braless -> rless
branca -> rnc
brand -> rnd
brands -> rnds
brans -> rns
brass -> rss
brats -> rts
braun -> run
brauns -> runs
bravas -> rvs
braver -> rver
braving -> rving
brays -> rys
bread -> red
breadbox -> redox
breadboxes -> redoxes
breading -> reding
breadline -> redline
breadlines -> redlines
breadroot -> redroot
breads -> reds
bream -> rem
breams -> rems
breast -> rest
breasted -> rested
breasting -> resting
breasts -> rests
breda -> red
brenda -> rend
brian -> rin
briana -> rin
briand -> rind
bribable -> rile
bringabout -> ringout
bringingabout -> ringingout
bringsabout -> ringsout
brita -> rit
broad -> rod
broadas -> rods
broads -> rods
broca -> roc
brocas -> rocs
bryan -> ryn
bstar -> str
bstars -> strs
bteam -> tem
bteams -> tems
burana -> urn
bushera -> usher
buta -> ut
butane -> utne
byear -> yer
cabanas -> cns
cabbie -> cie
cabello -> cello
caber -> cer
cabin -> cin
cabit -> cit
cable -> cle
cabling -> cling
cabot -> cot
cabots -> cots
cabover -> cover
caleb -> cle
caliban -> clin
cambia -> cmi
carabao -> cro
carbo -> cro
carbs -> crs
carib -> cri
caribes -> cries
caribs -> cris
carob -> cro
cartab -> crt
cartabs -> crts
chiba -> chi
chilblain -> chillin
coalbin -> colin
cobain -> coin
cobalt -> colt
cobra -> cor
collab -> coll
comeabout -> comeout
comesabout -> comesout
comingabout -> comingout
confab -> conf
crabbed -> cred
crabbier -> crier
crabby -> cry
crabs -> crs
criedabout -> criedout
criesabout -> criesout
cryabout -> cryout
cryingabout -> cryingout
cutbait -> cutit
cutsbait -> cutsit
cuttable -> cuttle
dabbing -> ding
dabomb -> dom
dabon -> don
dabsat -> dst
dabulls -> dulls
darby -> dry
daube -> due
daybed -> dyed
dccab -> dcc
debar -> der
debase -> dese
debater -> deter
debaters -> deters
debra -> der
disabuse -> disuse
disabused -> disused
disabuses -> disuses
disabusing -> disusing
divebar -> diver
divebars -> divers
doable -> dole
dobattle -> dottle
dorab -> dor
dovebar -> dover
drabs -> drs
dropsabeat -> dropset
drugabuse -> druguse
drugabuser -> druguser
dubai -> dui
durban -> durn
earbob -> ero
earbobs -> eros
ebate -> ete
ebates -> etes
ecolab -> ecol
enbas -> ens
esbat -> est
estab -> est
faber -> fer
fabian -> fin
fabiano -> fino
fabians -> fins
fabled -> fled
fablers -> flers
fabray -> fry
fabrication -> friction
fabrications -> frictions
fbilab -> fil
fbilabs -> fils
flabbier -> flier
flabby -> fly
foodbabies -> foodies
forabit -> forit
forbad -> ford
furbabies -> furies
furbaby -> fury
gabbed -> ged
gabber -> ger
gabbro -> gro
gabbros -> gros
gabes -> ges
gabon -> gon
gabor -> gor
gambas -> gms
garbo -> gro
gaybar -> gyr
getab -> get
getabout -> getout
gilblas -> gills
gimbap -> gimp
goabout -> goout
gobad -> god
gobag -> gog
gobald -> gold
gobang -> gong
gotab -> got
grabbar -> grr
grabbars -> grrs
grabbier -> grier
greenbay -> greeny
gummibear -> gummier
gunban -> gunn
gunbans -> gunns
habeas -> hes
haber -> her
habit -> hit
habits -> hits
haboob -> hoo
hbeam -> hem
healable -> helle
hijab -> hij
hoban -> hon
hobart -> hort
hubbard -> hurd
iambs -> ims
iambus -> imus
ibanez -> inez
ibank -> ink
ibanker -> inker
ibankers -> inkers
ibanking -> inking
ibanks -> inks
ibars -> irs
iberia -> ieri
imbeat -> imet
immabe -> imme
inabit -> init
inabow -> inow
inacab -> inc
inbad -> ind
indaba -> ind
jabbed -> jed
jabber -> jer
jabot -> jot
jabots -> jots
jojoba -> jojo
jubal -> jul
juicebar -> juicer
juicebars -> juicers
justabout -> justout
kabobs -> kos
kabocha -> koch
kickabout -> kickout
kickedabout -> kickedout
kickingabout -> kickingout
kicksabout -> kicksout
killerabs -> killers
kimba -> kim
knifebar -> knifer
knifebars -> knifers
knockabout -> knockout
knockabouts -> knockouts
knockedabout -> knockedout
knocksabout -> knocksout
kobra -> kor
labia -> li
labial -> lil
labials -> lils
labiate -> lite
labor -> lor
laborday -> lordy
labour -> lour
labute -> lute
laybare -> lyre
lbeams -> lems
leavebe -> levee
libate -> lite
libera -> lier
lifebar -> lifer
lifebars -> lifers
lilbaby -> lily
linearb -> liner
lobar -> lor
loungebar -> lounger
loungebars -> loungers
lullaby -> lully
mabel -> mel
mabell -> mell
mabels -> mels
madlib -> mdli
mailable -> mille
mambas -> mms
mastaba -> mst
melba -> mel
melbas -> mels
miserably -> miserly
moab -> mo
mobilead -> moiled
mombasa -> moms
moveabout -> moveout
mubarak -> murk
nabbed -> ned
nabber -> ner
nabe -> ne
nabes -> nes
nabob -> no
nabobs -> nos
nabors -> nors
namib -> nmi
nbaer -> ner
nestable -> nestle
noball -> noll
nobama -> nom
noseabout -> noseout
nosedabout -> nosedout
nosesabout -> nosesout
notabit -> notit
nubia -> nui
obamaera -> omer
obamania -> omni
obamas -> oms
obrian -> orin
oldabe -> olde
oldbean -> olden
oncable -> oncle
onebar -> oner
oralb -> orl
orbach -> orch
orbad -> ord
pablo -> plo
pablum -> plum
pabst -> pst
pabsts -> psts
payable -> pyle
payables -> pyles
peabean -> peen
peabeans -> peens
pebas -> pes
perabo -> pero
picabo -> pico
pointatopointb -> pointtopoint
poobah -> pooh
poobahs -> poohs
prefab -> pref
presentably -> presently
probable -> prole
probables -> proles
rabats -> rts
rabbet -> ret
rabbets -> rets
rabbis -> ris
rabbit -> rit
rabbitt -> ritt
rabid -> rid
rabin -> rin
randb -> rnd
rawbar -> rwr
rayban -> ryn
rebabs -> res
rebag -> reg
rebags -> regs
rebait -> reit
rebas -> res
rebate -> rete
rehab -> reh
retab -> ret
rhumba -> rhum
riband -> rind
ribands -> rinds
roomba -> room
roombas -> rooms
rosebay -> rosey
roundabout -> roundout
rumba -> rum
rumbaba -> rum
rumbabas -> rums
rumbas -> rums
runabout -> runout
runabouts -> runouts
runatab -> runt
saban -> sn
sabato -> sto
sabbats -> sts
sabena -> sen
saber -> ser
sabers -> sers
sabin -> sin
sabina -> sin
sabine -> sine
sabines -> sines
sabor -> sor
sabot -> sot
sabots -> sots
sabras -> srs
samba -> sm
sambas -> sms
sarabi -> sri
satby -> sty
satiable -> stile
sawbill -> swill
sawbills -> swills
sawbit -> swit
sawbits -> swits
scarab -> scr
seabag -> seg
seabags -> segs
seabass -> sess
seabattle -> settle
seabattles -> settles
seabeast -> seest
seabed -> seed
seabeds -> seeds
sealab -> sel
sealable -> selle
sealabs -> sels
seeabout -> seeout
seesabout -> seesout
serbia -> seri
serbian -> serin
serbians -> serins
setabout -> setout
setsabout -> setsout
shabbier -> shier
shabbiest -> shiest
shabby -> shy
sheba -> she
shebear -> sheer
shebears -> sheers
sidebar -> sider
sidebars -> siders
simba -> sim
simbas -> sims
singable -> single
slabbing -> sling
slabs -> sls
snoozebar -> snoozer
sobad -> sod
sorbate -> sorte
stabber -> ster
stabbers -> sters
stabbing -> sting
stabile -> stile
stabiles -> stiles
stabs -> sts
starbuck -> struck
staub -> stu
strabo -> stro
subbass -> suss
swabbed -> swed
swabbing -> swing
tab -> t
tabaret -> tret
tabbed -> ted
tabbies -> ties
tabbing -> ting
taboo -> too
tabor -> tor
tabors -> tors
tabour -> tour
tabstops -> tstops
taebo -> teo
tarbaby -> try
tarbes -> tres
tba -> t
tbars -> trs
tbeam -> tem
teabag -> teg
teaball -> tell
teaballs -> tells
thebabe -> thee
theban -> then
thebay -> they
thebayarea -> theyre
thenba -> then
thinksabout -> thinksout
thoughtabout -> thoughtout
thunderbay -> thundery
tiebar -> tier
tiebars -> tiers
tobago -> togo
tobat -> tot
tomba -> tom
torbay -> tory
turban -> turn
turbaned -> turned
turbans -> turns
turnabout -> turnout
turnabouts -> turnouts
typeab -> type
typebar -> typer
typebars -> typers
unabashed -> unshed
urban -> urn
urbana -> urn
viable -> vile
vibra -> vir
wabbit -> wit
wabbits -> wits
warbaby -> wry
warby -> wry
webart -> wert
willowbay -> willowy
winebar -> winer
yabber -> yer
yabbers -> yers
yabooks -> yooks
yerba -> yer
zebra -> zer
